10 10 10 10 1 1 1 1 1 1 1 1 1 1 1 1 1 8 8 8
10 1 2 1 1 1 1 1 1 1 1 1 1 1 1 1 1 8 8 8
10 4 6 3 1 1 1 1 1 1 1 1 1 1 1 1 1 9 9 9
1 1 5 1 1 1 1 1 1 1 1 1 1 1 1 1 1 9 9 9
1 1 1 1 1 1 1 1 10 10 10 1 1 1 1 7 7 9 9 1
1 1 1 1 1 1 1 1 1 2 2 1 1 1 7 9 9 9 9 1
1 1 1 1 1 1 1 1 4 6 6 3 1 1 1 7 7 9 9 1
1 1 1 1 1 1 1 1 4 6 6 3 1 1 1 1 1 9 9 1
1 1 1 1 1 1 1 1 1 5 5 1 1 1 1 1 1 (9,11) (9,13) 1
1 1 1 1 10 1 1 1 1 1 1 1 1 1 1 1 1 9 9 1
1 1 1 1 1 1 1 1 1 1 1 1 1 1 1 1 1 9 9 1
1 1 1 1 1 1 1 1 1 1 1 1 1 1 1 1 1 9 9 1
1 1 1 1 1 1 1 1 1 1 1 1 1 1 1 1 1 9 9 1
1 1 1 1 1 1 1 1 1 1 1 1 1 1 1 1 1 9 9 7
1 1 1 1 1 1 1 1 1 1 1 1 1 1 1 1 1 9 9 7
#blob:3;1
#blob:10;5
